111111111
100000001
1000E0001
1PC000001
111111111