11111111
10000001
10000E01
10P00001
11111111