1111111111111111111111111111111111111111
10C0000000000000000111000010111110001001
11111111111111111100000100100000101C1001
1000000000000000010111010011111110111101
101111111111111101010C011110000010000001
1010000000000001000101000000000000001101
1010111110111111110111110111011111000001
1010000000000000000100000100000100000001
1011111110111111111111111111000111111101
1011111111111111111101010110000010000001
100000000000000000E100000000000011011101
1111111111111111111101111111111111011101
1000000000000000000001000001000000000101
1011111111111111111111110001111010111101
1010000000000000010101111000100010100001
1010100111111111010100000001101110111101
1010000001000000000000100000001000000101
1010111111011111111110101111101011111101
1010000000000000001110100000101010000001
1011111111111111101110111110101011111111
10000000P10C00000010000000000010000000E1
1111111111111111111111111111111111111111