11111111
10C00001
10000E00
100P0001
11111111