11111111
10C00001
10P00E01
10000001
11011111