11111111
11C11111
11111E11
1P111111
11111111