11111111
10C00001
10000P01
10000001
11111111