11111111111111111111
10010000000000001001
10010E0010010E001001
10011011100110111001
10010000100100001001
10000000000000000001
100C000000000000C001
10011111100111111001
10000000100100000001
1P000000000000000001
11111111111111111111