11111111
10C00001
10000E01
10000001
11111111