111111111
1A0000001
1000E0001
1PC000001
111111111